32 40
01 01 01 01 00 00 00 00 01 01 01 00 00 01 01 01 01 01 01 01 01 01 01 01 01 01 01 01 01 01 01 01
01 01 17 01 01 01 00 00 01 18 01 00 00 01 01 08 01 01 01 01 01 01 01 01 01 01 01 01 01 01 01 01
01 15 03 03 03 03 03 03 03 06 01 00 01 01 08 01 05 10 03 03 03 03 03 03 03 03 03 03 03 06 01 01
00 01 01 19 01 01 01 01 01 02 01 00 08 01 01 01 02 01 01 08 01 01 01 01 01 01 01 01 01 02 01 01
00 00 00 00 18 01 01 01 00 02 01 00 00 01 08 01 02 01 00 00 00 00 00 00 00 00 00 01 01 02 01 18
00 00 00 00 00 00 01 01 01 02 01 00 00 01 01 01 04 03 03 06 01 00 01 01 01 01 01 01 01 02 01 01
00 01 00 00 17 00 00 00 01 02 01 01 00 00 00 00 00 00 00 02 01 00 01 01 00 03 03 03 03 07 01 01
01 01 01 01 01 01 01 01 01 02 01 01 00 00 01 01 01 01 01 02 01 00 01 17 01 01 01 01 01 01 01 01
01 01 01 01 01 01 01 01 01 02 01 01 00 00 01 05 03 03 03 07 00 00 01 01 01 00 01 01 01 01 01 00
01 01 01 05 03 03 03 03 03 07 01 00 00 00 01 02 01 08 01 01 00 01 01 00 00 00 00 00 00 00 00 00
01 01 01 02 01 01 01 01 01 01 01 00 00 00 01 02 08 08 08 01 00 01 01 00 01 00 00 00 00 00 00 00
08 01 01 02 01 00 00 00 00 00 00 00 00 00 01 02 01 08 01 01 00 00 00 00 01 01 01 01 01 01 00 00
01 08 01 02 01 01 01 01 00 00 00 00 00 00 01 02 01 01 01 01 20 01 01 01 01 01 01 01 01 01 01 00
18 01 08 02 01 01 01 01 01 00 00 00 00 00 01 04 03 03 03 03 06 01 01 01 01 01 01 01 01 01 01 01
01 08 01 02 01 01 01 01 01 01 01 01 00 00 00 01 01 01 01 01 02 08 01 01 01 01 01 01 01 01 01 01
01 01 01 02 01 01 01 01 01 01 01 01 01 00 01 01 01 01 01 01 09 01 08 08 01 01 01 01 18 01 01 01
01 01 01 02 01 01 01 01 08 08 01 01 18 01 01 01 01 01 01 01 09 01 01 01 01 01 01 01 00 01 01 01
00 01 01 04 03 03 03 10 10 10 03 03 03 03 03 03 03 03 03 10 07 08 08 01 01 01 01 01 01 01 01 01
00 00 01 01 01 01 01 01 01 01 01 01 01 01 01 01 01 01 01 01 08 08 01 01 01 01 01 01 01 01 08 01
00 00 00 00 01 00 00 00 00 01 01 01 01 01 01 01 01 01 01 01 01 01 01 01 01 01 01 01 01 01 01 01
00 00 00 00 00 00 00 00 00 00 00 00 00 00 00 00 00 00 01 01 01 01 01 01 01 01 00 01 01 01 01 01
01 01 01 00 00 01 01 01 00 00 00 00 00 01 00 00 00 00 00 01 01 01 01 01 01 01 02 01 01 01 01 01
01 08 01 01 01 01 01 01 01 00 00 01 01 01 00 00 00 00 00 01 01 01 01 01 01 01 02 01 01 01 01 01
01 01 08 01 01 01 01 01 01 01 01 01 01 01 00 00 00 00 00 01 01 01 01 01 01 08 02 01 01 01 01 01
01 08 08 08 12 03 03 03 03 03 03 03 03 06 01 00 00 00 01 01 01 01 01 01 08 08 09 01 01 01 01 01
01 01 01 08 02 01 01 01 01 01 01 01 01 02 01 00 00 01 01 05 03 03 03 03 03 10 07 01 01 01 01 00
01 01 01 01 02 01 01 01 01 00 00 01 01 02 01 00 01 01 01 02 01 01 01 01 01 01 01 01 01 01 00 00
01 01 01 01 02 01 01 01 01 01 00 00 01 02 01 01 08 01 01 02 01 01 01 01 01 01 01 00 00 00 00 00
01 01 01 01 02 01 01 01 01 01 00 00 01 02 01 08 01 08 01 02 01 00 00 00 00 00 00 00 00 00 00 00
01 01 01 01 04 03 03 03 06 01 01 00 00 04 03 03 10 03 03 07 01 00 00 00 00 00 00 00 00 00 00 00
01 01 01 01 01 01 01 01 02 01 01 00 00 00 01 01 00 01 01 00 01 01 00 00 00 00 00 01 00 00 00 00
01 01 01 01 01 00 00 01 02 08 01 01 00 00 00 01 00 00 00 00 00 00 00 01 01 01 01 01 01 00 01 00
01 01 01 00 01 01 00 01 02 01 08 01 01 01 00 00 01 01 01 01 01 00 01 01 05 03 03 03 03 03 06 01
01 01 01 00 00 01 01 01 04 03 03 03 10 03 10 06 01 01 01 01 01 00 00 01 02 01 01 01 01 01 02 01
01 21 01 01 01 01 01 01 01 01 01 01 01 08 01 02 01 01 01 01 00 00 01 01 02 01 01 00 00 01 02 01
01 01 01 08 01 01 01 01 01 01 01 01 08 01 08 02 01 01 01 01 01 01 01 01 02 01 01 00 00 01 02 01
01 01 08 01 08 01 01 01 01 01 01 01 01 01 01 04 03 10 03 03 03 03 03 03 07 01 00 00 00 01 02 01
01 01 01 08 01 01 01 01 01 01 01 01 01 01 01 01 08 08 01 01 01 01 01 01 01 00 00 01 01 01 02 01
01 01 01 01 01 01 01 01 01 01 01 01 01 01 01 01 08 08 01 01 01 01 01 01 00 00 00 16 03 03 07 01
01 01 01 01 01 01 01 01 01 01 01 01 01 01 01 01 01 01 01 01 01 01 01 01 00 00 01 01 01 01 01 01