32 20
00 00 00 00 00 00 00 00 00 00 00 00 00 00 00 00 00 00 00 00 00 00 00 00 00 00 00 00 00 00 00 00
00 01 01 01 01 01 00 00 01 01 01 00 00 01 01 08 01 01 01 01 01 01 01 01 01 01 01 01 01 01 01 00
00 15 03 03 03 03 03 03 03 06 01 00 01 01 08 01 05 10 03 03 03 03 03 03 03 03 03 03 03 06 01 00
00 01 01 01 01 01 01 01 01 02 01 00 08 01 01 01 02 01 01 08 01 01 01 01 01 01 01 01 01 02 01 00
00 00 00 00 01 01 01 01 01 02 01 00 00 01 08 01 02 01 00 00 00 00 00 00 00 00 00 01 01 02 01 00
00 00 00 00 00 00 01 01 01 02 01 00 00 01 01 01 04 03 03 06 01 00 01 01 01 01 01 01 01 02 01 00
00 01 00 00 01 00 00 00 01 02 01 01 00 00 00 00 00 00 00 02 01 00 01 01 16 03 03 03 03 07 01 00
00 01 01 01 01 01 01 01 01 02 01 01 00 00 01 01 01 01 01 02 01 00 01 01 01 01 01 01 01 01 01 00
00 01 01 01 01 01 01 01 01 02 01 01 00 00 01 05 03 03 03 07 00 00 01 01 01 00 01 01 01 01 01 00
00 01 01 05 03 03 03 03 03 07 01 00 00 00 01 02 01 08 01 01 00 01 01 00 00 00 00 00 00 00 00 00
00 01 01 02 01 01 01 01 01 01 01 00 00 00 01 02 08 08 08 01 00 01 01 00 01 00 00 00 00 00 00 00
00 01 01 02 01 00 00 00 00 00 00 00 00 00 01 02 01 08 01 01 00 00 00 00 01 01 01 01 01 01 01 00
00 01 01 02 01 01 01 01 00 00 00 00 00 00 01 02 01 01 01 01 01 01 01 01 01 01 01 01 01 01 01 00
00 01 01 02 01 01 01 01 01 00 00 00 00 00 01 04 03 03 03 03 06 01 01 01 01 01 01 01 01 01 01 00
00 01 01 02 01 01 01 01 01 01 01 01 00 00 00 01 01 01 01 01 02 01 01 01 01 01 01 01 01 01 01 00
00 01 01 02 01 01 01 01 01 01 01 01 01 00 01 01 01 01 01 01 02 01 01 01 01 01 01 01 01 01 01 00
00 01 01 02 01 01 01 01 08 08 01 01 01 01 01 01 01 01 01 01 02 01 01 01 01 01 01 01 00 01 01 00
00 01 01 04 03 03 03 10 10 10 03 03 03 03 03 03 03 03 03 03 07 01 01 01 01 01 01 01 01 01 01 00
00 01 01 01 01 01 01 01 01 01 01 01 01 01 01 01 01 01 01 01 01 01 01 01 01 01 01 01 01 01 01 00
00 00 00 00 00 00 00 00 00 00 00 00 00 00 00 00 00 00 00 00 00 00 00 00 00 00 00 00 00 00 00 00